NO ./assets/textures/north.xpm
SO ./assets/textures/south.xpm
WE ./assets/textures/west.xpm
EA ./assets/textures/east.xpm
F 60,60,60
C 135,206,235

1111111111101
0000000000001
1010101010101
1000000000001
1011101110101
1010000E00001
1111111111011
