NO ./assets/textures/north.xpm
SO ./assets/textures/south.xpm
WE ./assets/textures/west.xpm
EA ./assets/textures/east.xpm
F 60,60,60
C 135,206,235

1111111111111
1000000000001
1010 01010101
1000000000001
1011101110101
1010000N00001
1111111111111
